{
	"Start": {
		"abs" : 9,
		"ord": 0
		},
	"Finish": {
		"abs" : 8,
		"ord": 20
		},
	"Matrix":
		[
			[1,1,1,1,1,1,1,1,1,1,1,1,1,1,1,1,1,1,1,1,1],
			[1,0,0,0,1,0,0,0,0,0,1,0,0,0,0,0,1,0,1,0,1],
			[1,0,1,0,1,0,1,1,1,0,1,1,1,1,1,0,1,0,1,0,1],
			[1,0,1,0,1,0,0,0,1,0,0,0,0,0,1,0,1,0,0,0,1],
			[1,0,1,1,1,1,1,1,1,0,1,0,1,1,1,0,1,0,1,0,1],
			[1,0,0,0,0,0,0,0,0,0,1,0,0,0,0,0,1,0,1,0,1],
			[1,0,1,1,1,0,1,1,1,1,1,0,1,1,1,1,1,0,1,0,1],
			[1,0,1,0,0,0,1,0,0,0,1,0,1,0,0,0,0,0,1,0,1],
			[1,0,1,1,1,1,1,0,1,0,1,0,1,0,1,1,1,0,1,0,0],
			[0,0,0,0,0,0,1,0,1,0,1,0,1,0,1,0,1,0,1,1,1],
			[1,1,1,1,1,0,1,0,1,0,1,0,1,0,1,0,1,0,1,0,1],
			[1,0,0,0,0,0,1,0,1,0,1,0,0,0,1,0,1,0,1,0,1],
			[1,0,1,1,1,1,1,1,1,0,1,1,1,1,1,0,1,0,1,0,1],
			[1,0,0,0,0,0,0,0,1,0,0,0,0,0,0,0,1,0,0,0,1],
			[1,1,1,1,1,1,1,1,1,1,1,1,1,1,1,1,1,1,1,1,1]
		]
}